　⬛⬛⬛⬛⬛⬛⬛⬛⬛⬛⬛⬛⬛⬛⬛⬛⬛
　⬛🎯　　　　　　　　　　　　　🐑⬛
　⬛　⬛⬛⬛　⬛　　⬛　⬛　　⬛　⬛
　⬛　⬛　　　⬛　　⬛　⬛⬛　⬛　⬛
　⬛　⬛⬛　　⬛　🐄⬛　⬛　⬛⬛　⬛
　⬛　⬛　　　⬛　　⬛　⬛　　⬛　⬛
　⬛　⬛　　　　⬛⬛　　⬛　　⬛　⬛
　⬛🐑　　　　　　　　　　　　　🐕⬛
　⬛⬛⬛⬛⬛⬛⬛⬛⬛⬛⬛⬛⬛⬛⬛⬛⬛
