　⬛⬛⬛⬛⬛⬛⬛⬛⬛⬛⬛⬛⬛⬛⬛⬛⬛⬛
　⬛🎯　🐕⬛⬛　　　⬛　　⬛　　　　⬛
　⬛　　　　　　　⬛　　　　　　🐑　⬛
　⬛　　　　　　⬛⬛　　　　　　⬛⬛⬛
　⬛⬛　　　　　　　⬛　　　　　　　⬛
　⬛　　　　　　⬛⬛　　　　　　⬛⬛⬛
　⬛⬛　　　　　　　⬛　　　　　　　⬛
　⬛　　　　　　⬛⬛　　　　　　⬛⬛⬛
　⬛⬛　　　⬛⬛　　⬛　　　　　　　⬛
　⬛　　　⬛⬛　　　　　　⬛⬛　　　⬛
　⬛　　　　　　　⬛　　　　　　　⬛⬛
　⬛　　　　　　⬛⬛　　　　　　⬛⬛⬛
　⬛⬛　　　　　　　⬛　　　　　　　⬛
　⬛　　　　　　⬛⬛　　　　　　⬛⬛⬛
　⬛⬛　　　　　　　⬛　　　　　　　⬛
　⬛　🦆　　　　⬛⬛　　　　　　⬛⬛⬛
　⬛　　　　　　　　⬛　　　　　🎯　⬛
　⬛⬛⬛⬛⬛⬛⬛⬛⬛⬛⬛⬛⬛⬛⬛⬛⬛⬛
